R   600 600
  NO ./textures/walls/eagle.xpm
 SO ./textures/walls/colorstone.xpm
   WE    ./textures/walls/bluestone.XPM
        EA ./textures/walls/murt.XPM


  S    ./textures/sprites/pillar.XPM
   F  0,0,0
C 255,0,50

11111111111111111111111111   111111111111
    000000000000000011001111100000000001
11111000000000000110000000000000000011111111111111111
11111111111111111000000001110000011000000000000000001
100000000110000000002000E0000100011000000000000000001
10000000011000020000000000000000000000011111111111111
1001111001100111000000000000111111111111
1001  1000000000000000011110000000000001
100111100011000000000001  11110000000001
1001110000110000000000111110000001100001
1000000000000011111111111111100000001111
100000000000001 10000001   1000000000001
111111111111111 11111111   1111111111111
